Dhyana Slokam & Jaya Jaya Deva | Shankarabharanam - Adi
Naradam Pranamami | Kedaram - Adi
Bhajare Vyasadevam | Begada - Adi
Bhajare Manasa Sri Sukadevam | Behag - Adi
Pibare mama rasane | Kamas - Adi
Bhagavatham Srunutha | Sriranjani - Adi
Avatheerno jayathi | Vasantha - Adi
Gachchathi nandagruham | Ahiri - Adi
Gokulamaaseeth paramanandam | Bowli - Adi
Smaraami santhatham | Neelaambari - M chapu
Nirmamantha dadhi | Bowli/ Bhoopalam - Adi 
Pachati yashoda | Sri - Adi
Laalayathi yashoda | Surutti - Adi
Chumbathi yashoda | Hindolam - Adi
Madhava Madhava maa yahi | Mohanam - Adi
Yehi Nanda Nandana | Surutti - Adi
Snaapayati Yashoda | Pantuvarali - Adi
Snaapayati Yashoda | Malayamarutham - Adi
Bhooshayati Yashoda | Kuntalavarali - Adi
Roditi balamukundo | Dhanyasi - Adi
Amba dehi me | Kedaragowlai - Adi
Koyamantarbhavane | Ataana - Adi
Nanadakumaaram anuyaama | Yadukulakamboji - Adi
Amba yasode kathitam | Huseni - Adi
Bheeshayati Yasoda | Behag - Adi
Yehi bala gopala | Punnagavarali - Adi
Amba yasode maakuru kopam | Saranga - Adi
Aagaccha gopala | Bhairavi - Triputa
Bhakshayati Bhagavaan | Bilahari - Adi
Bhajare manasa gopalam | Desh - Adi
Babanda yashoda | Simendramadyamam - Adi
Amba yashode | Thodi - Adi
Aananda: saha nandagruhe | Kalyani - Ado
Yaahi muraare | Kedaragowlai - Adi
Preshayati Yasoda | Behag - Adi
Pashyata pashyata | Malayamarutham - Adi
Nandakumaro vijayate | Kalyani - Adi
Bhajare manasa nandakishoram | Saranga - Adi
Nrutyati giridhari | Sindubairavi - Adi
Kreedati yamunaasalile | Kuntalavarali - Adi
Krushnam bhaje sada | Deshikathodi - Adi
Avalokaya sakhi | Behag - Adi
Viharati yamunatheere | Karaharapriya - Adi
Pashyata nandabalam | Madhyamaavathi - Adi
Bhajare gopalam | Danyasi - Adi
Nrutyati paramatmaa | Punnagavarali - Adi
Vaadayate muraleem | Senchu
